3 3 3 3 3 3 3 3 3 3 3 3 3 3 3 3 3 3 3 3
0 8 8 8 8 8 8 8 8 8 8 8 8 8 8 8 8 8 8 1
4 B C C C C C C C C C C C C C C C C D 2
4 2 3 3 3 3 3 3 3 3 3 3 3 3 3 3 3 3 4 2
4 2 3 3 3 3 3 3 3 3 3 3 3 3 3 3 3 3 4 2
4 2 3 3 3 3 3 3 3 3 3 3 3 3 3 3 3 3 4 2
4 2 3 3 3 3 3 3 3 3 3 3 3 3 3 3 3 3 4 2
4 2 3 3 3 3 3 3 3 3 3 3 3 3 3 3 3 3 4 2
4 7 8 8 8 8 8 8 8 8 8 8 8 8 8 8 8 8 9 2
5 C C C C C C C C C C C C C C C C C C 6
3 3 3 3 3 3 3 3 3 3 3 3 3 3 3 3 3 3 3 3
